xxxxxxxxxxxxxxxxxxxxxxxxxxxxxxxxxxxxxxxx
xR                        x            x
x         tttth                        x
x         t          x                 x
x         t                       x    x
x                                      x
x    x                                 x
x                       x              x
x                                      x
x         x                            x
x                                      x
x                           x          x
x                                      x
x                                      x
x                  x             x     x
x                                      x
x                        xx            x
x                                      x
x     x                                x
x                                      x
x                                      x
x                                      x
x                         x            x
x                                      x
x           x                          x
x                                      x
x                              x       x
x                                      x
x              xx                      x
xxxxxxxxxxxxxxxxxxxxxxxxxxxxxxxxxxxxxxxx